1111111111111
100C000000001
1000000000001
100C000000E01
100P000C00001
1111011111111
