1111111111111
1000000000001
1000P00000001
1000000000E01
1000000000001
1111111111111
