1111111111111
100C000000001
1000000000001
1000000000E01
1001000000001
1111111111111
