1111111111111
100C000000001
1011111111101
1011110001101
101C1CC101E01
100P1CC100011
1111111111111
