1111111111111
100C000000001
1000000000001
1000000000E01
100P000000001
1111111111111
